1111111111111111111111111111111111
10000000C000001E1000000C0000000001
110001P100100010101001000000010101
1010010010101010001001000000010101
100000000000000CC00000000000000001
1111111111111111111111111111111111