11111111111111111111111111111
1E00000000000C00000C000000001
10100101001000101001000010101
101001001010100010010R0010101
1P0000000C00C00000000000000C1
11111111111111111111111111111