11111111111111111111111111111
1E000000000000000000000000001
10100101001000101001000010101
101001001010100010010R0010101
1P000000000000000000000000001
11111111111111111111111111111