11111111111111111111111111111
1E000000000000000000000000001
10100101001000101001000010101
10100100101010001001000010101
1P000000000000000000000000001
11111111111111111111111111111