11111111111111111111
1000000E100011000C01
100000000000010C0001
10101000000000C10001
10000000000001000001
10C01000000000000001
1100000C010000000001
10100000000000000C01
100C00101100C0000011
10000000000001000001
100000C0000000000101
10000000000000000001
1C0001000000C0000001
10000100000000000101
10C0000000000P00CC01
10010000010000C00001
1000000000000C0C1001
101000C00C0010000001
1000000100100100C0C1
1C0000001001000CC001
100000100000000C0001
10010000000010010001
10100000000000010C01
11111111111111111111
