111111111111
10010010C001
100E00000001
100100000011
101100001101
111000101011
10C00011PC01
100000100001
1001000010C1
100010C10111
101100011001
111111111111
