111111
1001C1
111101
100E01
1C1PC1
111111