1111111
10010C1
1111101
1000001
100E011
1C1PC01
1111111