1111111111111111111111111111111111111
1111111111111111111111111111111111111
10100100101010100010010C00001C0101001
1010010010101010001001000000101001001
1110011011111000011001111100001000011
10000000C000001E1000000C0000000000001
110001P100100010101001000000010101101
1010010010101010001001000000010101001
100000000000000CC00000000000000001111
1000000000000010000100000000000001001
1000000000000010000100000000000001001
1000000000000010000100000000000001001
10000000C1000010000100000000C00000001
1010010010101010001001000000101001001
1111111111111111111111111111111111111
1111111111111111111111111111111111111